гэж	pron. as,that
би	pron. I
өөрийн	pron. his,own
тэр	pron. he,she,would
байсан	v. was,had,were,did,been
нь	adv. for, with, from, is, to, a/an, in, which, will, fact, whose
дээр	prep. on,up,over
байна	v. are,have,has,am
тэд	pron. they
байх	v. be,stay
үед	adv. at,when,during
нэг	adj. one,same,single
энэ	pron. this,it
өөр	adj. by,else,another
халуун	adj. hot
үг	n. word
харин	adv. but,while,rather
ямар	pron. what
зарим	adj. some
хэрэв та	pron. you
буюу	conj. or
олон тоо	art. the
 -ийн	prep. of
болон	conj. and
бид	pron. we
болох	v. can,could,may,happen
гарах	v. out,to leave/exit
бусад	n. other,rest,except
хийх	v. do,make,to do
тэдний	pron. their
цаг	n. time,hour,clock,term
хэрэв	conj. if
хэрхэн	adv. how
гэж хэлсэн	v. said,told
тус бүр	adj. each
хэлэх	v. tell
вэ	v. does
багц	v. set
гурван	adj. three
хүсэж байна	v. want
агаар	n. air
сайн	adj. well,good,better,good
мөн	adv. also,too
тоглох	v. play,to play
жижиг	adj. small
эцсийн	adj. end,final
тавих	v. put,lay,to put
нүүр хуудас	n. home
уншсан	v. read
гар	n. hand,arm,arm
порт	n. port
их хэмжээний	adj. large
ид шид	n. spell
нэмэх	v. add
тэр ч байтугай	adj. even
газар	n. land, place, area, station, earth
энд	adj. here,there
байх ёстой	adv. must,should
том	adj. big
өндөр	adj. high,tall,tall
зэрэг	adj. such, order, degree
дагах	v. follow
акт	n. act
яагаад	adv. why
асуух	v. ask,to ask
эрэгтэй	n. men
өөрчлөлт	v. change
явав	v. went
гэрэл	n. light,shine
төрөл	n. kind,type
унтраах	v. off
хэрэгтэй	v. need
байшин	n. house
зураг	n. picture,figure,chart
оролдох	v. to try
ану-ын	pron. us
дахин	adv. again
мал	n. animal
амьтны	n. animal
цэг	n. point
ээж	n. mother
дэлхийн	n. world
ойролцоо	adj. near
барих	v. build,take,hold,catch,touch
өөрөө	pron. self
дэлхий	n. earth
аав	n. father,dad
ямар ч	???. any,no
шинэ	adj. new,fresh
ажил	n. work,job
хэсэг	n. part, piece, fraction, section, bit, segment
авах	v. get,to take
хийсэн	v. made
амьдарч байна	v. live
хаана	adv. where
дараа	conj. after,then
буцааж	adj. back
бага	adj. little,low,less
нь зөвхөн	adj. only
дугуй	adj. round,wheel,tire,circle
хүн	n. man,people,who,person
жил	n. year
ирсэн	v. came
шоу	n. show
бүх	adj. every,all
намайг	pron. me
өгөх	v. give,provide,to give
манай	pron. our
дагуу	prep. under
нэр	n. name
маш их	adj. very,much,lot
дамжуулан	n. prepthrough
зүгээр л	adv. just
хэлбэр	n. form,shape
өгүүлбэр	n. sentence,phrase
агуу их	adj. great
гэж боддог	v. think
гэж хэлэх	v. say
туслах	v. to help
мөр	n. line,string,shoulder
өөр	adj. differ,vary
ээлж	v. turn
шалтгаан	n. cause,reason
гэсэн үг	n. mean,meant
өмнө	prep. before, ago
алхам	n. move,step
эрх	adj. right
хүү	n. boy,interest,son,son
хуучин	adj. old
ашиглах	v. use
таны	pron. your
арга зам	n. way
тухай	prep. about
олон	adj. many
тэднийг	pron. them
бичих	v. write,to write
шиг	adj. like
тийм	adj. so
эдгээр	n. these
түүнийг	pron. her,him
урт	adj. long
зүйл	n. thing
 -г үзнэ үү	v. see
хоёр	adj. two
харах	v. look,watch,view,to see/look at
дэлгэрэнгүй	adj. more
өдөр	n. day
явах	v. go,ride,to go/leave for
ирэх	v. come,arrive,to come
тоо	n. number,count
сонсогдож	n. sound
хамгийн их	adj. most
миний	pron. my
мэдэх	v. know,to know
ус	n. water
илүү	adj. than
дуудлага	n. call
эхний	adj. first
доош	prep. down
тал	n. side
яг одоо	prep. now
олох	v. find,locate
дарга	n. head,chair
зогсож	v. stand
хуудас	n. page,sheet,slip
улс орон	n. country,nation
олдлоо	v. found
хариулт	n. answer
сургууль	n. school
ургадаг	v. grow
судалгаа	v. study
хэвээр	adj. still
сурах	v. learn,to study
ургамал	n. plant
хамгаалах	v. cover
хоол хүнс	n. food
нар	n. sun
дөрвөн	adj. four
хооронд	prep. between
улсын	n. state
байлгах	v. keep, carry, retain
нүдний	n. eye
хэзээ ч	???. never
өнгөрсөн	adj. last,past
зөвшөөрөх	v. let
гэж бодсон	v. thought
мод	n. stick,wood/tree
гаталж	n. cross
аж ахуй	n. farm
хатуу	adj. hard,solid
эхлэл	n. start
байж болох юм	n. might
түүх	n. story,pick,history
харсан	v. saw
хол	adj. far
далайн	n. sea
зурж	v. draw
зүүн	adj. left,east
сүүлээр	adj. late
урсгал	v. run,flow
хийж чадахгүй	???. don’t
гэж сонгоод	v. press,select
ойр	adj. close
шөнө	n. night
бодит	adj. real
амьдрал	n. life
хэдэн	adj. few, how many
хойд	adj. north
ном	n. book
авч явах	v. carry
авч	v. took
шинжлэх ухаан	n. science
идэж	v. eat
өрөө	n. room
найз	n. friend
эхэлсэн	v. began
санаа	n. idea
загас	n. fish
уулын	n. mountain
зогсоох	v. stop
нэг удаа	adj. once
үндсэн	adj. base,main,basic
сонсооч	v. hear
морь	n. horse
тайрах	v. cut
байгаа эсэхийг	adj. sure
өнгө	n. color
нүүр	n. face,front,lake
нээлттэй	adj. open
шиг санагддаг	v. seem
хамтдаа	adj. together
дараагийн	adj. next
цагаан	adj. white
хүүхдүүд	n. children
эхлэх	v. begin,to start,to begin
авсан	v. got
алхах	v. walk
жишээ	n.example
хөнгөвчлөх	v. ease
цаас	n. paper
бүлэг	n. group
үргэлж	adv. always
дуу хөгжим	n. music
тэдгээр	pron. those
аль аль нь	adj. both
тэмдэг	n. mark,sign,symbol
нь ихэвчлэн	adj. often
бичиг	n. letter
хүртэл	conj. until
милийн	n. mile
голын	n. river
машины	n. car
хөл	n. feet, leg
тусламж	v. care
хоёр дахь	adj. second
хангалттай	adj. enough
энгийн	adj. plain,simple
охин	n. girl,daughter
ердийн	adj. usual
залуу	adj. young
бэлэн	adj. ready
дээр дурдсан	prep. above
хэзээ нэгэн цагт	adv. ever
улаан	adj. red
жагсаалт	n. list
хэдийгээр	conj. though
мэдрэх	v. feel
хэлэлцүүлэг	v. talk
шувуу	n. bird
удахгүй	adj. soon
байгууллага	n. body, organ
нохой	n. dog
гэр бүл	n. family
шууд	adj. direct
загвар	v. pose
орхих	v. to leave
дуу	n. song
хэмжих	v. measure
хаалга	n. door
бүтээгдэхүүн	n. product
хар	adj. black
богино	adj. short
тооны нэр	n. numeral
анги	n. class
салхины	n. wind
асуулт	n. question
бүрэн	adj. complete, full
хөлөг онгоц	n. ship
тэн	adj. equal
хагас	adj. half
чулуулгийн	n. rock
гал түймэр	n. fire
урд	adj. south
асуудал	n. problem,matter
мэдэж байсан	v. knew
өнгөрөх	v. pass
учир	n. since, reason
дээд	prep. top
бүхэлд	adj. whole
хаан	n. king
инчийн	n. inch
үржүүлэх	v. multiply
юу ч биш	???. nothing
мэдээж	n. course
хүч	n. force
хөх	adj. blue
объект	n. object
шийдвэр	v. decide
газрын гадаргын	n. surface
гүн гүнзгий	adj. deep
сар	n. moon
арал	n. island
систем	n. system
завгүй	adj. busy
туршилтын	n. test
бичлэг	n. record
завь	n. boat
нийтлэг	adj. common
алт	n. gold
аль болох	adj. possible
нисэх онгоц	n. plane
үүний оронд	n. stead
гайхдаг	v. wonder
инээд	v. laugh
гүйж	v. ran
шалгах	v. check
тоглоом	n. game
тэнцэхгүй	v. equate
өнгөрөөх	v. miss
авчирсан	v. brought
дулаан	n. heat,warm
цас	n. snow
авчрах	v. bring
хэрэв тийм бол	???. yes
холын	adj. distant
бөглөх	v. fill
будаг	n. paint
хэл	n. language, tongue
дунд	prep. adj. among, middle, satisfactory
нэгж	n. unit
эрчим хүч	n. power
нарийн	adj. fine, thin
тодорхой	adj. certain,clear
ялаа	v. fly
унах	v. fall,to fall
хүргэдэг	v. lead
хашхирах	v. cry
харанхуй	adj. dark
машин	n. machine,car
тэмдэглэл	n. note
хүлээх	v. wait,to wait
төлөвлөгөө	n. plan
од	n. star
хайрцаг	n. box
нэр үг	n. noun
талбар	n. field
зөв	adj. correct,proper
боломжтой	v. able
фунт	n. pound
хийгдсэн	v. done
гоо сайхан	n. beauty
хөтөч	v. drive
зогсов	v. stood
агуулсан	v. contain
заах	v. teach,to teach
долоо хоног	n. week
өгсөн	v. gave
ногоон	adj. green
өө	???. oh
хурдан	adj. quick
боловсрох	v. develop
далай	n. ocean
чөлөөт	adj. free
минут	n. minute
хүчтэй	adj. strong
тусгай	adj. special
оюун ухаан	n. mind
ард	prep. behind
сүүл	n. tail
үйлдвэрлэх	v. produce
орон зай	n. space
сонслоо	v. heard
хамгийн сайн	adj. best
үнэн	adj. true
зуун	adj. hundred
таван	adj. five
санаж	v. remember
эрт	adj. early
баруун тийш	adj. west
газрын	n. ground
хүрэх	v. reach,to touch
үйл үг	n. verb
дуулах	v. sing,to sing
сонсох	v. listen,to listen
зургаан	adj. six
хүснэгт	n. table
аялал жуулчлалын	n. travel
өглөө	n. morning
арван	adj. ten
хэд хэдэн	adj. several
эгшиг	n. vowel
рүү	adv. toward
дайн	n. war
эсрэг	adj. against,opposite
хэв маяг	n. pattern
удаан	adj. slow
төв	n. center
хайр	n. love,favor
мөнгө	n. money
үйлчлэх	v. serve,to serve
гарч ирэх	v. appear
авто зам	n. road
газрын зураг	n. map
бороо	n. rain
дүрэм	n. rule
удирдах	v. govern
татах	v. pull
хүйтэн	adj. cold
мэдээлэл	n. notice
дуу хоолой	n. voice
эрчим хүчний	n. energy
ан	v. hunt
магадлалтай	adj. probable
ор	n. bed
ах дүү	n. brother
өндөг	n. egg
эсийн	n. cell
гэдэгт итгэдэг	v. believe
магадгүй	adv. perhaps
гэнэт	adj. sudden
дөрвөлжин	n. square
төлөөлөх	v. represent
урлаг	n. art
хичээл	n. subject
бүс нутаг	n. region
хэмжээ	n. size,deal
барагдуулах	v. settle
үг хэлэх	v. speak
жин	n. weight
ерөнхий	n. general,chief
мөс	n. ice
тойрог	n. circle
хос	n. pair
оруулах	v. include
хуваагдал	v. divide
үет	n. syllable
эсгий	v. felt
их	adj. grand,a lot of
бөмбөг	n. ball
одоогоор	adv. yet
долгионы	n. wave
унагаах	v. drop
зүрхний	n. heart
өнөөгийн	n. present
хүнд	adj. heavy
бүжгийн	n. dance
хөдөлгүүр	n. engine
албан тушаал	n. position
өргөн	adj. wide,broad
онгоцны далбаа	n. sail
материал	n. material
ой	n. forest
суух	v. sit,to sit
уралдаан	n. race
цонх	n. window
дэлгүүр	n. store,shop,electronics store,antique shop
зуны	n. summer
галт тэрэг	n. train
унтах	v. sleep,to sleep
нотлох	v. prove
цорын ганц	adj. lone
хөлөө	n. leg
дасгал	n. exercise
ханын	n. wall
холбох	v. mount,connect
хүсвэл	v. wish
тэнгэр	n. sky
туз-ийн	n. board
баяр хөөр	n. joy
өвөл	n. winter
орохдоо	v. sat
бичсэн	v. written,wrote
зэрлэг	adj. wild
арга хэрэгсэл	n. instrument,tool
хадгалах	v. kept,save
шилэн	n. glass
өвс	n. grass
үнээ	n. cow
зах	n. edge,market
айлчлал	v. visit
зөөлөн	adj. soft,gentle
хөгжилтэй	adj. fun
гэрэл гэгээтэй	adj. bright
хий	n. gas
цаг агаар	n. weather
сарын	n. month
сая	adj. million
үүрэх	n. bear
барианы	v. finish
аз жаргалтай	adj. happy
гэдэгт найдаж байна	v. hope
цэцэг	n. flower
хувцаслан	v. clothe
хачин	adj. strange
илааршсан	v. gone
гадаад худалдааны	n. trade
аялгуу	n. melody
аялал	n. trip,hiking
оффис	n. office
хүлээн авах	v. receive
эгнээ	n. row
агшин	n. mouth
яг	adj. exact,quite
үхэх	n. die
наад зах	adj. least
гай	n. trouble
орө	n. shout
үрийн	n. seed
ая	n. tone
нэгдэхийг	n. join
санал болгож байна	v.suggest
цэвэр	v.clean
завсарлага	n. break
эмэгтэй	n. lady,woman
талбай	n. yard,squire
босох	v.rise,to get up
муу	adj. bad
цохилт	v. blow
газрын тос	n. oil
цусны	n. blood
өссөн	v. grew,rose
хувь	n. fraction, percent
холино	n. mix
баг	n. team
утас	n. wire,thread
зардал	n. cost
алдагдсан	v. lost
бор	adj. brown
өмсөж	v. wear
цэцэрлэг	n. garden
тэнцүү	adj. equal
илгээсэн	v. sent
сонгох	v. choose,to choose
буурсан	v. fell
таарах	v. fit,to fit
шударга	adj. fair
банк	n. bank
цуглуулах	v. collect
хяналтын	v. control
аравтын	n. decimal
чихний	n. ear
эвдсэн	v. broke
хэрэг	n. case
алах	v. kill
мөч	n. moment
хэмжээний	n. scale
чанга	adj. loud
хавар	n. spring
ажиглах	v. observe
хүүхэд	n. child,baby
шулуун	adj. straight
гийгүүлэгч	n. consonant
ончтой үр дүн	n. dictionary
сүү	n. milk
хурд	n. speed
арга	n. method
төлөх	v. pay,to pay
нас	n. age
хувцас	n. dress,clothes
үүл	n. cloud
нам гүм	adj. quiet
чулуу	n. stone
жижигхэн	adj. tiny
өсөх	v. climb
сэрүүн	adj. cool
зураг төсөл	n. design
ядуу	adj. poor
туршилт	n. experiment
доод	prep. bottom
гол	n. key,stream,major,river
төмрийн	n. iron
хавтгай	adj. flat
хорин	adj. twenty
арьс	n. skin
инээмсэглэл	n. smile
уртасгахад	n. crease
нүх	n. hole
үсрэх	v. jump,to jump
найман	adj. eight
тосгон	n. village
хангасан	v. meet
эх	n. root,original
худалдан авах	v. buy,to buy
өсөлт	v. raise
шийдвэрлэх	v. solve
металл	n. metal
эсэх	conj. whether
түлхэх	v. push
долоон	adj. seven
догол	n. paragraph
гурав дахь	adj. third
болно	v. shall
зохион байгуулав	v. held
үс	n. hair
тайлбарлах	v. describe,to explain
тогооч	n. cook,cook/chef
шал	n. floor
аль нэг	adj. either
үр дүн	n. result
шарах	v. burn
толгой	n. hill,head
аюулгүй	adj. safe
муур	n. cat
зууны	n. century
авч үзэх	v. consider
хууль	n. law
эрэг	n. coast,shore
хуулбар	n. copy
чимээгүй	adj. silent
хөрс	n. soil
өнхрөх	v. roll
температур	n. temperature
хуруу	n. finger
аж үйлдвэрийн	n. industry
үнэ цэнэ	n. value
тэмцэл	v. fight
худал	v. lie
зодож	v. beat
сэтгэл татна	v. excite
байгалийн	adj. natural
мэдрэмж	n. sense
капитал	n. capital
тийм юм байхгүй	???. won’t
аюул	n. danger
жимс	n. fruit
баян	adj. rich
зузаан	adj. thick
цэрэг	n. soldier
үйл явц	n. process
үйл ажиллагаа явуулах	ov. perate
практик	n. practice
тус тусад	adj. separate
хүнд хэцүү	adj. difficult
эмч	n. doctor
үү	???. please
хамгаалах	v. protect
үд	n. noon
газар тариалан	n. crop
орчин үеийн	adj. modern
элемент	n. element
хит	n. hit
оюутан	n. student
булангийн	n. corner
нам	n. party
хангамж	n. supply
бөгж	n. ring
тэмдэгт	n. character
шавьж	n. insect,insects
татлаа	v. caught
хугацаа	n. period
харуулж байна	v. indicate
радио	n. radio
ярьсан	v. spoke
атомын	n. atom
хүний	n. human
үр нөлөө	n. effect
цахилгаан	n. electric,lightening/bolt
найдах	v. expect
ясны	n. bone
төмөр замын	n. rail
төсөөлж	v. imagine
санал нэгтэй	v. agree
ийн	adv. thus
ахмад	n. captain
таах	v. guess,to guess
шаардлагатай	adj. necessary,require
хурц	adj. sharp
жигүүр	n. wing
бий болгох	v. create
хөрш	n. neighbor
угаалгын	v. wash
бат	n. bat
олон хүн	n. crowd
эрдэнэ шиш	n. corn
харьцуулах	v. compare
шүлэг	n. poem
хонх	v. bell
хамааралтай	v. depend
мах	n. meat
урэх	v. rub
хоолой	n. tube
алдартай	adj. famous
доллар	n. dollar
айдас	n. fear
нүдний хараа	n. sight
нимгэн	adj. thin
гурвалжин	n. triangle
гариг	n. planet
яарах	v. hurry
колони	n. colony
уул уурхайн	n. mine
зангиа	v. tie
оруул	v. enter
хайлт	v. search
илгээх	v. send
шар	adj. yellow
буу	n. gun
боломж олгох	v. allow
хэвлэх	v. print
нас барсан	adj. dead
спот	n. spot
цөлийн	n. desert
нэхэмжлэл	n. suit,claim
одоогийн	adj. current
өргөгч	v. lift
мастер	n. master
зам	n. track,path,road
эцэг, эх	n. parent
хэлтэс	n. division
бодис	n. substance
дараах	v. post
зарцуулах	v. spend
хөвч	n. chord
өөх	adj. fat
баяртай	adj. glad
эзлэх хувь	n. share
талх	n. bread
үнэ	n. charge,price
бар	n. bar,tiger
санал болгох	v. offer
боол	n. slave
нугас	n. duck
шуурхай	n. instant
зах зээлийн	n. market
нутагших	n. populate
дэгдээхэйн	n. chick
хайрт	n. dear
дайсан	n. enemy
хариулах	v. reply,to answer
ундаа	n. drink,beverages,soda
тохиолддог	v. occur
дэмжлэг үзүүлэх	v. support
хэл яриа	n. speech
мөн чанар	n. nature
хүрээ	n. range
уурын	n. steam
хөдөлгөөн	n. motion
шингэн	n. liquid
гуалин	n. log
коэффицентийг	n. quotient
шүд	n. teeth,tooth
бүрхүүл	n. shell
хүзүү	n. neck
хүчилтөрөгчийн	n. oxygen
элсэн чихэр	n. sugar
үхэл	n. death
нэлээн	n. pretty
ур чадвар	n. skill
эмэгтэйчүүд	n. women
улирал	n. season
үүний шийдэл	n. solution
соронз	n. magnet
мөнгөн	adj. silver
талархлын	v. thank
салбар	n. branch
хүсч байгаа эд зүйлс	n. match
дагавар	n. suffix
ялангуяа	adv. especially,particular
инжрийн	n. fig
айдаг	adj. afraid
асар их	adj. huge
эгч	n. sister
ган	n. steel
хэлэлцэх	v. discuss
урагш	prep. forward
ижил төстэй	adj. similar
чиглэх	n. guide
туршлага	n. experience
оноо	n. score
алим	n. apple
худалдан авсан	v. bought
удирдуулсан	v. led
давирхай	n. pitch
цув	n. coat,rain coat
олон нийтийн	n. mass
карт	n. card
хамтлаг	n. band
олс	n. rope
хожил	v. win
мөрөөдөж	n. dream
орой	n. evening
нөхцөл байдал	n. condition
малын тэжээл	n. feed
нийт	n. total
үнэр	n. smell
хөндий	n. valley
ч	???. nor
давхар	adj. double
суудал	n. seat
үргэлжлэх	v. continue
блок	n. block
малгай	n. hat
борлуулах	v. sell
амжилт	n. success
компани	v. company
хасах	v. subtract
үйл явдал	n. event
усанд сэлж	v. swim
эхнэр	n. wife
гутал	n. shoe,boots
мөрөн	n. shoulder, shoulder
тархах	v. spread
зохион байгуулах	v. arrange
бааз	n. camp
зохион бүтээх	v. invent
хөвөн	n. cotton
төрөлхийн	adj. born
тодорхойлох	v. determine
есөн	adj. nine
ачааны машин	n. truck
дуу чимээ	n. noise
түвшин	n. level
боломж	n. chance
цуглах	v. gather
сунгах	v. stretch
хаях	v. throw
үл хөдлөх хөрөнгийн	n. property
багана	n. column
молекул	n. molecule
буруу	adj. wrong
саарал	adj. gray
давтан	v. repeat
бэлтгэх	v. prepare
давс	n. salt
хамар	n. nose
олон тооны	adj. plural
уур хилэн	n. anger
тив	n. continent
бүр	n. everyone
сайхан	adj. nice,fine/nice
урьд	prep. before
тогтох	v. determine
өмгөр	adj. very narrow
нэгэн	art. a/an
өвгөн	n. old man
эмгэн	n. old woman
чинээ	n. size
энх	adj. peaceful
эрүүл	adj. healthy
саруул	adj. clear,lucent,serenity
амьдрах	v. to live,to live
гэх	v. to say
зовлон	n. suffering
гараа	n. starting point
муудах	v. to decay
хаяанд	prep. nearby
хөөрхий	adj. pitiful
дуудах	v. to call,to call out
хажуу	prep. edge,side
хүүхэлдэй	n. doll
сонс	interj. i say!
хэн	pron. who
битгий	???. do not
үзүүлэх	v. to show
хэрвээ	conjunc. if
чамд	pron. you
тохиолдох	v. to occur
хооллох	v. to feed
яах	adv. how
зөвлөх	v. to suggest
сэтгэл	n. spirit
ингэх	adv. in this way/manner
үнсэх	v. to kiss,to kiss
нас барах	v. to die,to die
харамсан	adv. pitifully
гашуудах	v. to grieve
нэлээд	adv. much
удсан	adj. mature, stale
авгай	n. aged woman
ууртай	adj. angry
чинь	pron. me
догшин	adj. fierce
зантай	adj. grumpy
хорон	adj. mischievous
хойт	adj. step-(family member) e.g. step-parent
хорлох	v. to hurt
хорлонтой	adj. evil
цамаан	adj. fastidious
үлдэх	v. continue,remain,to stay
хорогдох	v. crouch,dwindle,escape,linger
эцэг	n. parent,father
гандах	v. crumble,wilt,wither
галлах	v. fire (to burn?)
зуух	v. to bake, bite,stove
зөөх	v. to carry,transfer,to carry
цэвэрлэх	v. to clean,to clean
шан	n. compensation,fee
сүүдэр	n. shade
тайвшрах	v. to appease,console
уух	v. to drink,to drink
амсах	v. to sample,savor
уулга	n. yell,cry
байгаа	adj. existent
түгжих	v. to lock, fasten
дотроо	prep. inwards
пин	n. barn
саах	v. to milk
гэгч	adj. so-called
өнөөх	v. inherent
болгох	v. to convert,render
болгон	adj. every
үзэсгэлэнтэй	n. beauty, loveliness
хэлшгүй	adj. unspeakable
үлгэр	n. fable, fairytale
улам	adj. more
төрөх	v. to give birth,to be born, generate
цаана	adj. beyond,farther
хав	n. doggy
усан	adj. aquatic
цутгах	v. to cast, flood, stream
салхи	n. wind,wind/breeze
шуугих	v. jangle, fizz, clutter
намар	n. autumn,autumn
эргэ	n. precipice, steep rock or cliff
тойрох	v. to beset, circle
сүг	n. apparition, ghost
тор	n. cage, mesh, net
нэхэх	v. to weave, chase
нөгөө	adj. other
оймс	n. footgear, stockings,socks
ээрэх	v. to falter, hesitate, to spin
оноох	v. to appoint, impose, mete
тэгээд	adv. then
охид	n. girl, sister
ажиллах	v. to do, get, work,to work
ганц	adj. lone single
баллуур	n. eraser
гэрийн даалгавар	n. homework
дэвтэр	n. notebook
маш	n. very
онц	n. excellent
самбар	n. white board
сандал	n. chair
спорт заап	n. gym
сурагч ширээ	n. desk
толь бичиг	n. dictionary
үзүүрлэгч	n. sharpener
үзэг	n. pen
үсэг	n. letter
хавтас	n. cover/folder
харандаа	n. pencil
цавуу	n. glue
цагийн хуваарь	n. timetable of lesson
цэцгийн сав	n. flower pot
шалгалт	n. test
ширээ	n. table
шугам	n. ruler
эгшиг үсэг	n. vowel
хүнсний ногоо	n. vegetable
байцаа	n. cabbage
вандуй	n. peas
лууван	n. carrots
өргөст хэмх	n. cucumber
перец	n. black pepper
сонгино	n. onion
төмс	n. potato
улаан лууван	n. radish
улаан лооль	n. tomato
улаан манжин	n. beet
хулуу	n. pumpkin
чинжүү	n. green pepper
шар лууван	n. carrot
шош	n. beans
буурцаг	n. beans
шар манжин	n. turnip
амтат зүрж	n. orange
бөөрөлзгөнө	n. raspberry
бэрсүүт жүрж	n. tangerine
гадил	n. banana
гүзээлзгэнэ	n. strawberry
интоор	n. cherry
киви	n. kiwi
лийр	n. pear
нимбэг	n. lemon
нэрс	n. blueberry
тарвас	n. watermelon
тоор	n. peach
усан үзэм	n. grape
үзэм	n. raisin
хад	n. currant,госк
хан боргоцой	n. pineapple
чангаанз	n. apricot
чавга	n. plum
тариа	n. cereal
бялуу	n. cake/pie
бин	n. pancake
гамбир	n. pancake
гурил	n. flour
гоймон	n. noodles
жигнэмэг	n. biscuit/cookies
зуурсан гурил	n. dough
өрмөнцөр	n. waffle
үр тариа	n. grain
будаа	n. rice
амттан	n. spices
ёотон	n. lump suger/cube
мax	n. meat
адууны мах	n. horse meat
гахайн мах	n. pork
гахайн утсан мах	n. bacon
зайдас	n. hot dog
өндег	n. egg
тахианы мах	n. chicken
тарваганы мах	n. marmot
үхрийн мах	n. beef
хонины мах	n. mutton
хиам	n. sausage
хоол	n. meals
зууш	n. dessert/snack
оройн хоол	n. dinner
өдрийн хоол	n. lunch
өглөөний цай	n. breakfast
хээрийн хоол	n. picnic
шөл	n. soup
цагаан идээ	n. dairy products
бяслаг	n. cheese
зайрмаг	n. ice-cream
тараг	n. yogurt
хайлмаг	n. melted butter
цөцгийн тос	n. butter
цөцгий	n. cream
дарс	n. wine
жимсний шүүс	n. juice
кофе	n. coffee
цай	n. tea
шар айраг	n. beer
гал тогооны хэрэгсэл	n. kitchen utensils
аяга	n. bowl
будаа агшаагч	n. rice cooker
данх	n. kettle
дийз	n. saucer
махны машин	n. meat grinder
өндөг хагалагч	n. egg beater
сэрээ	n. fork
савх	n. chopstick
сэнжтэй аяга	n. cup
таг	n. lid/cover
таваг	n. plate
тогоо	n. potato
ус буцалгагч	n. water boiler
хайруулын таваг	n. frying pan/skillet
хутга	n. knife
холигч	n. mixer
халбага	n. spoon
хапуун сав	n. thermos
хундага	n. glass
шарагч	n. broiler
шанага	n. ladle
шүүр	n. strainer,broom
шарах шүүгээ	n. oven
агуулах	n. storage
эоорь	n. storage
алчуур	n. towel
аяганы шүүгээ	n. cupboard
буйдан	n. sofa
бие засах өрөө	n. restroom
галын өрөө	n. kitchen
гадаа жорлон	n. outhouse
граш	n. garage
зурагт	n. television/tv
дэр	n. pillow
дээвэр	n. ceiling
тааз	n. ceiling
жорлон	n. toilet
зочны өрөө	n. living room
зөөлөн сандал	n. armchair
индүү	n. iron
индүүний ширээ	n. ironing board
орны даавуу	n. sheets
оёдлын машин	n. sewing machine
паар	n. radiator
суурь	n. basement
тавилга	n. furniture
тагт	n. balcony
телефон утас	n. telephone
тоос сорогч	n. vacuum cleaner
түлхүүр	n. key
yraaryyp	n. sink
угаалгын машин	n. washing machine
угаалгын өрөө	n. bath/laundry room
унждаг чийдэн	n. light
усанд орох онгоц	n. bathtub
үүдний өрөө	n. hall
ширээний бүтээлэг	n. table cloth
ширээний чийдэн	n. lamp
шүршүүр	n. shower
хана	n. wall
ханын шүүгээ	n. closet
хашаа	n. yard
хивс	n. carpet/rug
хогийн гаргуул	n. dust pan
хоолны өрөө	n. dining room
хөгжим	n. tape recorder,music
хөнжил	n. blanket
хөргөгч	n. refrigerator/fridge
хөшиг	n. curtain
хүүхдийн өрөө	n. kid’s room
цонхны тавцан	n. window sill
шалны хулдаас	n. linoleum
яндан	n. chimney
булган малгай	n. sable hat
бүс	n. belt
бээлий	n. gloves
гутлын үдээс	n. shoe string
гэрийн шаахай	n. slippers
даашинз	n. dress
дотуур хувцас	n. briefs
дотуур цамц	n. t-shirt
жинс өмд	n. jeans
майк	n. undershirt
ноосон цамц	n. sweater
ороолт	n. scarf
өмд	n. pants/trousers
пальто	n. coat
пиджак	n. blazer
пүүз	n. sneakers/running shoes
татуурга	n. suspenders
тирко оймс	n. nylons/tights
шилэн оймс	n. nylons/tights
туфль	n. high heel shoes
тэлээ. бүс	n. belt
унтлаганы хувцас	n. night gown
урт оймс	n. stockings
усны хувцас	n. swim suit
халат	n. house dress
хантааз	n. vest
хормогч	n. apron
хослол	n. suit
хүрэм	n. jacket
эмэгтэй цамц	n. blouse
эрэгтэй цамц	n. shirt
шуба	n. fur coat
юбка	n. skirt
ax	n. brother
ач охин	n. niece
зээ охин	n. niece
ач хүү	n. nephew
зээ хүү	n. nephew
авга ах	n. uncle
нагац ах	n. uncle
бэр эгч	n. sister in law
бэр дүү	n. sister in law
нагац эгч	n. aunt
авга эгч	n. aunt
насанд хүрсэн хүн	n. adult
нөхөр	n. husband
өвөө	n. grandfather
үеэл	n. cousin
хамаатан садан	n. relatives
хүргэн ах	n. brother in law
хүргэн дүү	n. brother in law
эмэгтэй хүн	n. woman
эмэгтэй хүүхэд	n. girl
эмээ	n. grandmother
эрэгтэй хүн	n. man
эрэгтэй хүүхэд	n. boy
эцэгэх	n. parents
гаригууд	n. days of the week
даваа	n. monday
мягмар	n. tuesday
лхагва	n. wednesday
пүрэв	n. thursday
баасан	n. friday
бямба	n. saturday
ням	n. sunday
цаг хугацаа	n. time
ажлын өдөр	n. weekday
амралтын өдөр	n. weekend
дараа жил	n. next year
3 өдрийн өмнө	n. 3 days ago
заримдаа	adv. sometimes
ихэвчлэн	adv. usually
маргааш	n. tomorrow
нар жаргасан орой	n. sunset
нар мандах үе	n. sunrise
нөгөөдөр	n. day after tomorrow
нэг цаг	n. hour
өчигдөр	n. yesterday
өдөр бүр	n. every day
өчигдөр орой	n. last night
cap	n. month
сарын дараа	n. after a month
уржигдар	n. day before yesterday
үдээс хойш	n. afternoon
үд дунд	n. noon
хараахан	n. yet
хоног	n. day/24 hours
2 жилийн өмнө	n. 2 years ago
шөнө дунд	n. midnight
улиралууд	n. seasons
зун	n. summer
байгаль	n. nature
аянга	n. thunder
газар хедлелт	n. earthquake
ган гачиг	n. drought
зэрэглээ	n. mirage
манан	n. fog
мөндөр	n. hail
нуур	n. lake/pond
рашаан	n. spring
солонго	n. rainbow
уул	n. mountain
халуун хүйтэн	n. temperature
хунгар	n. drift
цан	n. frost
цасан шуурга	n. blizzard
шавхай	n. slush
шиврээ бороо	n. drizzle
шороо	n. soil
шуурга	n. storm
элс	n. sand
амьтад	n. animals
алаг тахь	n. zebra
анааш	n. giraffe
арслан	n. lion
баавгай	n. bear
буга	n. deer
булга	n. sable
бух	n. bull
гахай	n. pig
гөлөг	n. puppy
гөрөөс	n. antelope
гүрвэл	n. lizard
заан	n. elephant
зараа	n. hedgehog
зурам	n. gopher
илжиг	n. donkey
ирвэс	n. leopard
ишиг	n. kid
могой	n. snake
мэлхий	n. frog
сармагчин	n. monkey
сарлаг	n. yak
тарвага	n. marmot
торой	n. piglet
тугал	n. calf
туулай	n. hare/rabbit
тэмээ	n. camel
унага	n. foal
үнэг	n. fox
үхэр	n. cow
үхэр хулгана	n. rat
халим	n. whale
хандгай	n. elk/moose
хонь	n. sheep
хулгана	n. mouse
хурга	n. lamb
хэрэм	n. squirrel
чоно	n. wolf
шанаган хорхой	n. tadpole
шар үхэр	n. ox
шилүүс	n. lynx
ямаа	n. goat
яст мэлхий	n. turtle/tortoise
аалз	n. spider
жоом	n. cockroach
бясаа	n. bug
зөгий	n. bee
хачиг	n. tick
хувалз	n. tick
царцаа	n. grasshopper
шоргоолж	n. ant
цох хорхой	n. ladybug
шумуул	n. mosquito
эрвээхэй	n. butterfly
болжмор	n. lark/sparrow
бүргэд	n. eagle
галуу	n. goose
тахианы дэгдээхэй	n. chicken
тагтаа	n. pigeon
тогоруу	n. crane
тоншуул	n. woodpecker
тоть	n. parrot
хараацай	n. swallow
хөхөө	n. cuckoo
хун	n. swan
хэрээ	n. crow
шаазгай	n. magpie
шар шувуу	n. owl
шонхор	n. falcon
цацагт хяруул	n. turkey
элээ	n. vulture
тас	n. vulture
ятуу	n. grouse
дэс тоо	n. ordinal numbers
дүрс	n. shapes
долоон енцөгт	n. heptagon
зургаан өнцөгт	n. hexagon
зууван	n. oval
конус	n. cone
куб	n. cube
мушгиа	n. spiral
найман өнцөгт	n. octagon
өнцөг	n. angle
пирамид	n. pyramid
таван өнцөгт	n. pentagon
тэгш өнцөгт	n. rectangle
хүний бие	n. parts of the body
алга	n.palm, is not
ам	n. mouth
бугуй	n. wrist
булчин	n. calf
гарын сарвуу	n. hand
гуя	n. thigh
гэдэс	n. stomach
магнай	n. forehead
дух	n. forehead
мэнгэ	n. birthmark
нуруу	n. back/spine
нүд	n. eye
өвдөг	n. knee
өгзөг	n. buttocks
өсгий	n. heel
сормуус	n. eyelash
суга	n. armpit
ташаа	n. hip
тохой	n. elbow
уруул	n. lip
хацар	n. cheek
хөлийн тавхай	n. foot
хөмсөг	n. eye brow
хелийн хуруу	n. toe
хумс	n. finger nail
хүй	n. navel
цээж	n. chest
чих	n. ear
шагай	n. ankle
эрүү	n. chin
эрхий хуруу	n. thumb
яс	n. bone
эдлэлийн	n. jewelry store
бичгийн хэрэгслийн	n. stationary
гутлын дэлгүүр	n. shoe store
зоогийн газар	n. restaurant
их дэлгүүр	n. department store
ломбард	n. pawn shop
номындэлгүүр	n. book store
ногооны мухлаг	n. vegetable stand
сонины мухлаг	n. newsstand
спортын барааны	n. sporting goods store
талхны	n. bakery
тасаг	n. department
тооцоо	n. bill
уран зургийн	n. art gallery
үйлчилгээний төв	n. service center
хариулт мөнгө	n. change
хивсний дэлгүүр	n. carpet store
хувцасны дэлгүүр	n. clothing store
худалдааны төв	n. shopping center
хөгжмийн дэлгүүр	n. music store
хүнсний дэлгүүр	n. grocery store
хүнсний зах	n. supermarket
цайны газар	n. cafeteria
эмийн сан	n. drugstore
суурин	n. town
автобус	n. bus
автобусны буудал	n. bus stop
авто зогсоол	n. parking lot
амьтны хүрээлэн	n. zoo
барилга	n. building
байр.сууц	n. apartment
гудамж	n. street
дүүрэг	n. district
кино	n. movie/film
кино театр	n. cinema
концерт	n. concert
музей	n. museum
өргөн чөлөө	n. avenue
сүм	n. church
театр	n. theater
усан сан	n. swimming pool
үзэсгэлэн	n. exhibition
үйлдвэр	n. factory
хот	n. city, town
хороолол	n. micro district
хүн ам	n. population
цэнгэлдэх хүрээлэн	n. stadium
цагдаагийн газар	n. police station
цирк	n. circus
шөнийн клуб	n. night club
шуудан	n. post office
эмнэлэг	n. hospital
эрүүл мэндийн төв	n. health center
спорт ба тоглоом	n. sports and games
аварга	n. champion
алхалт	n. jogging
ан агнуур	n. hunting
бильярд	n. billiards
боулинг	n. bowling
бокс	n. boxing
бөхийн барилдаан	n. wrestling
гар бөмбөг	n. volleyball
гимнастик	n. gymnastics
гүйлт	n. running
дасгалжуулагч	n. trainer
дугуй уналт	n. bicycling
морь уналт	n. horse riding
өрселдөгч	n. competitor
поло	n. polo
сагсан бөмбөг	n. basketball
сур	n. archery
байт сур	n. archery
теннис	n. tennis
тэмцээн	n. competition
усан сэлэлт	n. swimming
хожигдогч	n. loser
хоккей	n. hockey
хөл бөмбөг	n. football
хүндийн өргөлт	n. weight lifting
цанын спорт	n. skiing
цом	n. cup
шатар	n. chess
ширээний теннис	n. ping pong
эмээл	n. saddle
ялагч	n. winner
ажил алба	n. jobs and work
аж ахуйн эзэн	n. farmer
багш	n. teacher
бие хамгаалагч	n. bodyguard
бизнесмен	n. businessman
бичээч	n. typist
бүжигчин	n. dancer
гал сөнөөгч	n. fireman
гоо сайханч	n. beautician
гэрийн багш	n. tutor
дуучин	n. singer
жолооч	n. driver
жүжигчин	n. actor/actress
зохиолч	n. writer
зураач	n. artist
илбэчин	n. magician
инженер	n. engineer
касс	n. cashier
менежер	n. manager
механик	n. mechanic
мөрдөгч	n. detective
мужаан	n. carpenter
ня-бо	n. accountant
орчуулагч	n. translator
сэтгүүлч	n. journalist
талхчин	n. baker
цагдаа	n. policeman
уих-ын гишүүн	n. parliament
үсчин	n. barber
хаалгач	n. doorman
харваач	n. archer
хөлсний ажилчин	n. wage worker
хуульч	n. lawyer
цэвэрлэгч	n. cleaner
шууданч	n. postman
шүдний эмч	n. dentist
шүүгч	n. judge
эмч	n. doctor
худалдаа	n. business
наймаа	n. business
албан татвар	n. tax
баланс тэнцэтгэл	n. balance
барьцаа.зээл	n. mortgage
бэлэн мөнгө	n. cash
гэрээ, хэлцэл	n. contract
данс тооцоо	n. account
жилийн тайлан	n. annual report
зээл	n. credit
орлого	n. income
өртөг шан	n. fee
өр төлбөр	n. debt
санхүү-н шалгалт	n. audit
сонирхол	n. interest
түрээс	n. rent
удирдлага	n. management
үнэт цаас	n. bond
үнэ өртөг	n. cost
хандив	n. donation
хөрөнгө	n. capital
хөдөлмөрийн  гэрээ	n. labor contract
хөрөнгө оруулалт	n. investment
худалдаа	n. commercial
хувь ноогдол	n. quota
хувьцаа	n. stock
хувьцааны ноогдол	n. value
хүү.хувь	n. profit
цалингийн цэс	n. payroll
цалин хөлс	n. wage/salary
цуцлалт	n. write off
эдийн засаг	n. economy
эд юмс ба багаж	n. tools
алх	n. hammer
амны алчуур	n. napkin
бахь	n. pliers
бугуйвч	n. bracelet
бугуйн цаг	n. watch
гар цүнх	n. handbag
зангианы хавчаар	n. tie tack/clip
зүү	n. needle
зээлийнкарт	n. credit card
нимгэн цаас	n. tissues
нусны алчуур	n. handkerchief
нүдний шил	n. eyeglasses
сам	n. comb/brush
сойз	n. toothbrush
сүх	n. axe
тооны машин	n. calculator
түлхүүрийн оосор	n. key chain
түрийвч	n. wallet
үдээсний машин	n. stapler
үсний хавчаар	n. hairpin
хадаас	n. nail
хайч	n. scissors
хаягийн ном	n. address book
хөзөр	n. deck of cards
хөрөө	n. saw
хуруувч	n. thimble
хүзүүний зүүлт	n. necklace
цаасны хавчаар	n. paper clips
цүнх	n. briefcase
шүхэр	n. umbrella
ээмэг	n. earrings
үйл үгс	n. verbs
айх	v. to be afraid
аялах	v. to travel
барих	v. to build
барилга	v. to build
барьж авах	v. to catch
бодох	v. to think
болох	v. to be
байх	v. to be
бороо орох	v. to rain
будах	v. to paint
буцалгах	v. to boil
бүжиглэх	v. to dance
гайхах	v. to be surprised
гэрлэх	v. to be married
дуу гаргах	v. to sound
дуртай	v. to like
дуусах	v. to finish
жолоодох	v. to drive
завгүй байх	v. to be busy
завтай байх	v. to be free
зажлах	v. to chew
зарцуулах	v. to spend
өнгөрөөх	v. to spend
зогсох	v. to stand
зочлох	v. to visit
зөв бичих	v. to spell
зурах	v. to draw
идэх	v. to eat
инээх	v. to smile
итгэх	v. to believe
мартах	v. to forget
мөлхөх	v. to climb, crawl, creep
мөнгө олох	v. to earn
наах	v. to stick
нисэх	v. to fly
оёх	v. to sew
ойлгох	v. to understand
онгойлгох	v. to open
орилох	v. to shout
орчуулах	v. to translate
өвдөх	v. to be sick
өлсөх	v. to be hungry
өмсөх	v. to wear
зүүх	v. to wear
сайжрах	v. to improve
санах	v. to remember
солих	v. to change
сэлэх	v. to swim
сэрэх	v. to wake up
таалах	v. to enjoy
тайлах	v. to take off
талархах	v. to be glad
товч тайлах	v. to unbutton
тоолох	v. to count
түрүүлэх	v. to win
тэвчих	v. to endure
тэжээх	v. to feed
тэмдэглэх	v. to celebrate
угаах	v. to wash
уйлах	v. to cry
унших	v. to read
урих	v. to invite
усанд орох	v. to bathe
утсаар ярих	v. to call
уулзах	v. to meet
уурлах	v. to get angry
үзэх	v. to see
үнэрлэх	v. to smell
хаах	v. to close
хагалах	v. to chop (wood)
хазах	v. to bite
хаях	v. to throw
шидэх	v. to throw
хоол хийх	v. to cook
хоцрох	v. to be late
хөлрөх	v. to sweat
хөдлөх	v. to move
хөхрөх	v. to laugh
хувилах	v. to copy
худалдах	v. to sell
хүсэх	v. to want
хүрч ирэх	v. to arrive
хэвтэх	v. to lie
хэрэглэх	v. to use
хэрчих	v. to cut
хэрэгтэй байх	v. to need
цадах	v. to get full
цангах	v. to be thirsty
цас орох	v. to snow
цахилгаан татах	v. to zipper
цоожлох	v. to lock
чадах	v. to be able
чанах	v. to brew
шумбах	v. to dive
эвдэх	v. to break
эргэх	v. to turn
эрэх	v. to look for
хайх	v. to look for
ядрах	v. to tire
ярих	v. to speak
ярилцах	v. to talk
тэмдэг нэр	n. adjectives
алтан	adj. gold
амархан	adj. easy
анхны	adj. first
бага зэрэг	adj. a little bit
бороотой	adj. rainy
бохир	adj. dirty
буржгар	adj. curly
бүдүүн	adj. thick
бүрхэг	adj. overcast
гоолиг	adj. slender
гоё	adj. beautiful
дундуур	adj. half full
дүүрэн	adj. full
жаахан	adj. a little
залхуу	adj. lazy
зөвхөн	adj. only
илүү сайн	adv. better
инээдтэй	adj. funny
муухай	adj. ugly
намхан	adj. short
нартай	adj. sunny
нил ягаан	adj. violet/purple
өвчтэй	adj. sick
өтгөн	adj. strong
салхитай	adj. windy
тарган	adj. fat
тоостой	adj. dusty
тэнэг	adj. stupid
тэгш	adj. flat
ухаантай	adj. clever
үнэтэй	adj. expensive
халтиргаатай	adj. slippery
хамгийн муу	adj. worst
хөгшин	adj. old
хуурай	adj. dry
хүрэн	adj. brown
хэцүү	adj. difficult
хямдхан	adj.cheap
цайвар шаргал	n. beige
цастай	adj. snowy
цөөхен	adj. few
шаргал	adj. orange
шингэн	adj. weak
сул	adj. weak
эвдэрхий	adj. broken
ягаан	adj. pink/rose
асуух үг	n. question words
аль	pron. which
хаашаа	adv. where to
хаанаас	adv. where from
хэзээ	adv. when
хэнд	pron. to whom
хэний	pron. whose
хэр их	adv. how much
хэр олон	adv. how often
юу	pron. what
юунд	pron. to what
яаж	adv. how
үлдээх	v. to void, omit
асах	v. to ignite
тэртээ	prep. beyond
нийлэх	v. to unite
очих	v. to visit
хашхиралдах	v. to yell
хашгиралдах	v. to yell
гаргах	v. to launch, issue
гялайлаа	???. thank you
цааш	adj. farther
хойно	adj. then, after, behind
харлах	v. to feel sick or faint, to darken
мичид	n. evening star
гэрэлтэх	v. to shine
чичрэх	v. to shake
элгэн	adj. chesnut,maroon
цав	n. fissure, slit
цалин	n. salary
хазаар	n. bridle, bit
торгон	n. silk
давхих	v. to gallop
үүр	n. dawn
цайх	v. to dawn
хожуул	n. stump,stub
бут	n. bush
арай	adj. near
ядах	v. to have difficulty
арай ядан	adj. barely, hardly
шүүдэр	n. dew
бүрхэх	v. to cover
хөрөх	v. to freeze
хөших	v. to become numb, stiff
ухаа	adj. reddish
хонгор	adj. lovable
мандах	v. to rise
ээх	v. to warm
дулаацах	v. to heat up
хяруу	n. white frost
хатаах	v. to dry
өдөржингөө	adv. all day long
аглаг	n. solitude
тойрох	v. to encircle, get around
гавал	n. skull
цүү	n. spike
балмагдах	v. to be afraid
хөшөө	n. monument, memorial
мэт	adj. somewhat, as if, like, as
шингэх	v. to be absorbed, soaked, set
дээрх	prep. above
гэгээ	n. daylight, glow
дагжих	v. cower, shake
чичирсэн	adj. shivery, tremulous
аймшиг	n. awe, fear
зугтах	v. to avoid, flee
шигдэх	v. to sag, sink
доргих	v. to chatter, jiggle, vibrate
сүр	n. grandeur, majesty
чимээ	n. clamour, news, noise, word
бол	v. and, are, hold
суугаа	n. resident
нүдүүр	n. beater, pounder
шүүрдэх	v. to sweep, whisk
ирмэг	n. border, edge
дөхөх	v. to approach
доор	prep. below, beneath
бөхийх	v. to bend, bow
дор	prep. downstairs, under
даруу	adj. decent, humble, lowly
ир	n. blade, edge, spike
явуулах	v. despatch, send
хамаатан	n. kin, relative
цүг	adj. together
олдох	v. to be available
гэсэх	v. defrost
бат	adj. firm, steady
бөх	adj. firmness, strong
онгойх	v. to open
баялаг	n. abundance, exuberance, gold
үүд	n. gate, portal
нээгдэх	v. to open
хашгирах	v. exclaim, shout
урах	v. to germinate,grow
гуядах	v. flog
завдах	v. to intend, manage
хус	n. boy
орчих	v. spin, wheel
үүн	pron. it
бүү	???. no
шавхуурдах	v. flog, smack
дагуулах	v. append, guide
болиулах	v. cease, suspend
дэргэд	prep. beside, near
ухасхийх	v. recoil
хахир	adj. rugged, stern
над	pron. me
амар	n. rest, peaceful
маажих	v. to scratch
вандан	n. board, bench
хувин	adj. pitcher, bucket
дэгдээх	v. to stir up
дөчин	adj. forty years
аяга	n.	cup
дэгдээхий	adj. fledgling
нугас	n. duck, brain
боов	n. bun,turnover
амтат	adj. sweet
бал	conj. provided that ___, ball, honey
хөөсрөх	v. to foam, froth
исгэлэн	adj. eager, sour
хэм	n. degree, measure
цөм	n. core, nucleus
булан	n. anger, angle, nook
шуудай	n. bag, sack
ялгаа	n. departure, discrepancy, difference
биелэх	v. to fulfill
дүнгэнэх	v. to buzz, drone
хурхирах	v. to snore
эдлэх	v. to consume, taste
алба	n. employment
хариу	n. answer
гуних	v. to grieve
сэргэлэн	adj. alive, animated
тайван	adj. calm, composed
аргадах	v. appease, coax
дөнгөх	v. to barely do something
шувуухай	n. small bird
цэнхэр	adj. azure, blue
бүгдээрээ	adj. all
нашаа	adv. here
саатах	v. to linger, overstay
үй түмэн	n. multitude
дуугарах	v. clang, clatter
үр	n. kernel, seed
мөхлөг	n. grain, granule
тийш	prep. toward
үртэс	n. chip, crumb
ялгах	v. determine, differentiate, segregate, identify
олз	n. loot, plunder
омог	n. capture, pride, stem, kindred
намуу	n. poppy
цэцгийн	adj. floral
холилдох	v. to blend, jumble
бүгд	n. everybody, everyone
салгах	v. to deliver, detatch, disengage
гадаа	adj. outside
хангинах	v. blare, clang, jingle
шүгэлдэх	v. hiss, whistle
одоо	adv. now
уур	n. anger, wrath, vapor
шүүрэх	v. to grab, percolate, leak, grasp
цангинуулах	v. to shout in a shrill voice
алс	adj. far
амбаар	n. barn
сав	n. can, container, vase, uterus
айл	n. family
оготно	n. mouse
нааш	adv. this way
шуудайлах	v. to put in a bag
аяга	n. cup, bowl
цаагуур	adv. further, other side
шажигнах	v. creak, grate, sputter
навчис	n. leaf
шаржигнах	v. sizzle
пийшин	n. cooker, furnace
чих	n. ear, dock
чагнах	v. listen, monitor
дуулах	v. chant, crow
дуулдах	v. arise, carry
тавиур	n. leg, mat, stand
тавхай	n. foot, sole
хучих	v. envelop, inlay, tuck
дайлах	v. entertain, treat
энхрий	adj. affectionate, beloved, gentle
салах	v. conquer, divide, separate
амин	adj. crucial, essential, important
тод	adj. articulate, bold, bright
түлэх	v. burn, scald, sear
халаах	v. scorch, warm, heat
тус	v. profit, boost, help
хүргэх	v. bring, deliver, extend, touch
бэлэглэх	v. donate, give, present
шунаг	adj. lascivious
ул	n. relic, sole
зугтаах	v. abscond
эрс	adj. categorical, overwhelming
харайх	v. bounce, dance, jump
ороолгох	v. flog
мөчир	n. branch, graft, twig
өнгийн	adj. chromo-
тууз	n. band, ribbon
өлгөх	v. hang, suspend, dangle
хаагдах	v. shut
тос	n. fat, grease, oil
түрхэх	v. dab, paint, smear
сохлох	adj. blind
сугалах	v. draw, extract, pull
суулгах	v. install, diarrhea, embed
зүг	n. direction, way
сэдэх	v. brew, invent, plan, contrive
ёс	n. ceremony, procedure
эрхэмлэх	v. prefer, preference
дээдлэх	v. prefer
уламжлал	v.tradition, legacy
соёл	n. culture
заншил	n. custom, habit, ritual
багаар	adj. less
алдагдал	n. detriment, disadvantage, loss 
суртахуун	n. morals, ethics
доройтох	v. languish, fall
буй	adj. existing
өнөө	adv. now, today
залуусын	adj. junior
санаачлах	v. to initiate, dream up, invent
дээшлэх	v. to upgrade
энэхүү	n. the present
уралдаан	n. race, match
зорилго	n. point, purpose
орших	v. to exist
цацарч	n. marquee
суниах	v. to go
биеийн	adj. personal, bodily
чилэх	v. to go numb
өрөөнд	adj. indoors
зүтгэх	v. to endeavor, to seek
өгөө	n. obligation
гүйн	adv. hurriedly
дураараа	adj. willful, contrary, unsubmissive
хичнээн	adj. how many
хэлтэрхий	n. chip, morsel, fragment
чангаар	adj. loud, high
биз	adv. presumably
ургах	v. fertile, germinate, grow
уяа	n. cord, lacing, line
чимсэн	adj. decorated, ornate
тосолсон	adj. oil
хилэгнэх	v. to get angry
нүдэх	v. knock, pound, flail
эвдэх	v. demolish, scrap
цавчих	v. hack, hew
ядарч	adv. wearily
оронд	adv. instead
эцэх	v. to tire, weary
араас	prep. after
хөөсөн	adj. swollen
загнах	v. admonish, scold
зүхэх	v. abuse, curse
унтрах	v. burn out, die
нэмэр	n. supplement
унтарсан	adj. dead, extinct
ширтэх	v. stare at
гал	n. fire, heat
хатгах	v. bite, incite, instigate
нуугдах	v. hide, shelter, disappear
гүйх	v. to run, frisk
тийнхүү	adv. accordingly, such
цоо	adj. completely
булах	v. bury
хүссэн	adj. impatient, longing
уйтгар	n. boredom, flatness, sadness, weariness
чанар	n. attribute, character
маалинга	n. flax
ээрүүл	n. spindle, spinning wheel
эргэлдэх	v. reel, revolve, whirl
нарийхан	adj. delicate, slim
эвхэх	v. fold
утсаар	v. to wire
даавуу	n. cloth, jeans
торго	n. silk
гоёмсог	adj. elegant, delicate
сүвлэх	n. thread
алдах	v. lose,fail, mistake
зарах	v. sell, exert
ордон	n. castle, palace
аваачих	v. to take away
үнэлэх	v. apprise, price, measure
бэлэг	n. donation, gift, grant
сайшаагдах	v. approve
талархах	v. acknowledge, thank
зүрхлэх	v. dare, presume
тун	adv. absolutely, greatly, very
чиг	n. landmark
эвдэх	v. breach, trample
вий	conj. lest
эсгэх	v. to cut off
айх	v. to recoil
ийм	adj. such
хийц	n. fabric, cloth
оёо	n. stitch
тэгвэл	conj. when...,if...
тушаах	v. to submit, surrender, order
сувд	n. pearl
зарц	n. servant
үзэгдэх	v. to appear
өдрөөс	adj. from day
хойш	adj. next, hence
цагаахан	adj. white
өөрийнхөө	pron. my
удалгүй	adj. soon
хурим	n. wedding
ая	n. situation, condition, sound
тусч	adj. helping
хөөрхөн	adj. cute, nice
халаас	n. pocket
эрхэм	adj. important, master
зочид	n. guests
золгох	v. to meet
дархан	n. artisan, craftsman
хулгай	n. robbery, theft
харуул	n. convoy, escort, guard
манаа	n. guard, patrol, sentinel
болих	v. quit, discontinue
уруу	adj. downhill, downstream, downcast
царай	n. expression, look
гуниглах	n. regret
тайтгарах	v. appease, calm, console
хөвгүүдийн	adj. boyish
гутрах	v. gloom, droop
өөрсдөө	pron. themselves
манах	v. to guard, patrol
онцолсон	adj. emphatic
өвсөн	adj. grassy
зүүрмэглэх	v. nap, snooze
хонох	v. sleep, stay over
баярлах	v. indulge
эд	n. stuff, thing
нойр	n. dream, slumber
өвс	n. grass, hay, pasture
бүүр	adv. already
модон	adj. wooden
тонших	v. knock, peck
гэтэх	v. creep, sneak, prowl
өд	n. feather, pinion
одох	v. depart
гэмтэн	n. guilt, wrongdoing
хүндэт	adj. dear, honorable
амьтан	n. animal
мултрах	v. to slip away
баярлах	v. appreciate, rejoice, thank
мориор	n. riding
мордох	v. to ride
туулах	v. confront, pass, conquer
нутгийн	adj. native
буун	n. shot, discharge, report
чөдөрлөх	v. clog, fetter
унтаа	adj. dormant
баах	v. defecate
мөлжих	v. gnaw, milk, exploit
унаа	n. movement, transportation
халаглах	n. tut
заяа	n. luck
явган	adj. by foot, pedestrian
үхтлээ	adj. dead
зүлгэх	v. swab, brighten
өрөвдөх	v. pity, sympathize
зориг	n. confidence, daring, nerve
чонын	adj. like a wolf
шүргэх	v. contact, kiss, rub
хурдлах	v. race, lick
торон	adj. lacy, meshy
давах	v. confront, conquer, outdo
өвөр	adj. front, inside
цайз	n. castle, fortress
үлээх	v. inflate, puff, gas
хэц	n. tambourine
бөмбөр	n. drum
дэлдэн	adj. lop eared
сэрээх	v. awaken, rouse
ичгүүр	n. disgrace, humiliation
эцгийн	adj. paternal
хүндлэх	v. honor, regard,respect
шившиг	adj. disgrace, dishonor
даяар	adv. all over, throughout
зарлах	v. advertise, announce
дуугүй	adj. noiseless, silent
өршөөх	v. excuse, pardon, forgive
дэл	n. mane
гунихрах	v. to grieve
гуйх	v. beg, ask
суу	adj. genius
жүчээ	n. stall
орон	n. house, nation, situation
чулуун	adj. stony
шигтгээ	adj. inlaid
санагдах	v. appear, seem
гүнж	n. princess
асрагч	n. guardian, trustee
шивэгчин	n. maidservant
буцах	v. back, forswear, go, return
гүйцэх	v. outpace
олуул	n. flock
зугаалах	v. journey, stroll
дүүрэх	v. fill, pervade, swim
утгах	v. shovel, ladle
хөөх	v. chase away, eject
тэгэхэд	conj. whereas
хаа	n. whereabouts
нуух	v. cloak, conceal
хувирах	v. change, convert
тонгорох	v. somersault, spill
адил	n. analogy
найр	n. ball, feast
хоншоор	n. toe, muzzle
харагдах	v. appear, look
орноос	v. to get up out of bed
харамсах	v. to regret, be disappointed
хөтлөх	v. lead, prosecute
төрөлх	v. inherent, inborn, natural
бэгийн	adj. donative, gratuitous
авчруулах	v. send for
цочирдох	v. shocked
падхийн унар	n. thud
хүндэтгэх	v. adore, appreciate
үүр	n. cell, dawn, daylight
үүрд	n. eternity
биелэх	v. materialize
нутаг	n. habital, land
шийдэх	v. decide, conclude
хуваах	v. divide, bisect
хоосан	adj. deceitful, futile, bare, empty
дайралдах	v. to come across something
хамаг	adj. everything
тохиролцох	v. arrange, bargain, concert
айлгах	v. endanger, bluff, frighten, intimidate
сүрдэх	v. browbeat, intimidate
зуурах	v. grip, deadlock
билгийн	adj. fateful
мөнхийн	adj. eternal, everlasting
суллах	v. discharge, release
тул	conj. because, on account of
шарх	v. cut, wound
аних	v. close
эдгэрэх	v. recover
сэргэх	v. awaken
омгийн	adj. tribal
алах	v. assassinate, kill
тараах	v. carry, chase, dismiss
өөртөө	pron. oneself
аян	n. campaign, crusade, expidition
тайтгарах	v. quieten
жаргах	v. delight, pleasure
дүү	n. cousin
элдэх	v. crumple
элбэг	adj. bountiful, copious
дэлбэг	adj. lavish, luxuriant
агуулах	v. embody, store, reservoir
арвай	n. barley
бужигнах	v. to be muddled
орчин	n. environment
амжуулах	v. to manage in
хичээх	v. to take care, struggle
өмсөх	v. to wear
гялс	adv. passingly
дуусгах	v. to finish
мундаг	adj. huge
аягүй	adj. unbecoming
бараг	adj. A kind of ___,almost/nearly something____
эртхэн	adjv. go without delay
оруулах	v. to introduce, set up, go
бэлдэх	v. to prepare
хань	n. partner
гайгүй	adj. not too bad
таших	v. clap
нуга	n. lawn
бэлчих	v. graze
хөвсгөр	adj. fryable
намаг	n. swamp
намгийн	adj. growing in a wet or swampy area
атга	n. handful
чимх	v. handful
ширхэг	n. fiber, piece
аргаа барсан	adj. desperate
зээлдэх	v. lend, loan
тэг	n. nothing
гадар	n. outside, jacket, surface
өгөөрэй	interj. please
зайл	adj. away
өр	n. debt, liability
зээл	n. credit, loan
тавь	adj. fifty
гомдоох	v. annoy, grieve
өлөн	adj. hungry
хоосон	adj. blank, deceitful, futile
дэггүйтэх	v. wanton
чиглэх	v. focus, steer, trend
асар	n. citadel, pavilion, tent
царс	n. oak
хонгил	n. basement, corridor, tunnel
хийсгэх	v. blow away
харих	v. return, reverse
төлөө	prep. for, on behalf of
шидэт	n. wizard, fairy
бүтээлгийг авах	v. uncover
бүхэн	adj. each
доошоо	prep. down
гоо	adj. pretty
амралт	n. vacation
залгах	v. plug in
бассейн	n. pool
тэгэнгээ	conj. while
уралдах	v. to race
хаачих	v. where are you going
ийш	adv. here
бөөнөөрөө	adv. quickly
захиалах	v. order
хага	n. burst
сорох	v. suck
холдох	v. to withdraw
алив	phrase. let's
онгоц	n. plane
динозавр	n. dinosaur
буух	v. get off
цадтал	adv. to glut
ундлах	v. offer food
атаархах	v. envy
бүлтийх	v. stare
тэнд	adv. there
манайх	n. house
бүлэх	v. jab, stab
бүтээлэг	n. blanket
өрөг	n. game
бий	v. have
дэлгэх	v. display
атаархах	v.envy
улайх	v. confess, flush, redden
цатгалан	adj. satiated
элэгсэг	adj. loving
үдэх	v. see off
ижил	adj. same
унд	n. dish, beverage
цэмцийх	v. to become element
бүтээл	n. invention, work
гаслах	v. to mourn
зоорь	n. cellar
зутан	n. gruel
хайлах	v. flux, liquefy, melt
халих	v. overflow, spill, fill
асгарах	v. flow, spill
аальгүй	adj. flirty, prudish
шоглох	v. tease
эрэл	n. reconnaisance, assessment
өмнөхөн	n. eve
улалзах	v. gleam
балчир	n. green
хутгах	v. blend, mix, agitate
бөндгөр	adj. knobby
боргоцой	n. cone
бөөн	n. clogging, knot, clump
туух	v. drive, pursue
өлсгөх	v. starve
дарах	v. crush, extinguish, delete
хуурах	v. deceive, delude
жирийн	adj. common, humble
түмпэн	n. basin, pan
исгэрэх	v. hiss, sizzle, whistle
жавар	n. frost
тасхийж	adj. biting
шоглоом	n. fun, trick
гүн	adj. deep, innermost
огт	adv. absolutely, whatsoever
мөрдөх	v. chase, exercise
хүнхэр	adj. concave, curved in
доогуур	prep. below, beneath
хэвтэх	v. lie down
хөлдөөх	v. freeze
ердөө	adv. generally, ordinarily
асгах	v. dump, flood, shower
уут	n. bag, sack
бороохой	n. club, bludgeon
хаагуур	n. whereabouts
нурах	v. collapse, crumble
хэмхэрсэн	adj. battered, broken
засах	v. invite, steer, sail
залах	v. govern, invite, steer
нарсан	adj. related to pine trees
балбах	v. batter, club, pound
хуур	n. fiddle, violin
чөлөө	n. clearning, expanse, freedom
өршөөгч	n. philantropist
уутан	adj. related to sleeping
шахах	v. compel, constrain
булан	adj. anger, corner, nook
амтлах	v. sweeten, flavor, relish
хээ	n. ornament, pattern, stamp
тавтай	adj. cosy
тухтай	adj. comfortable
шонхор	n. falcon
тарих	v. to plant, grow, inject
тариачин	n. small farmer
хөлс	n. wage, rent, hire
ор	n. bed, vacancy, space
туслах	v. look to
гадна	adj. outside
ажиллах	v. activate
дэх	???. seems to be a modifier for previous word (e.g four=дөрөв, fourth=дөрөв дэх)
хорсох	v. hate
үзэмж	n. beauty
биеэ	pron. me
янзлах	v. repair, polish
янзалж	adj. modeled, related to a figure
ховдог	adj. greedy
бошинз	n. gown, frock
удаа	n. instance, time (as in "one time")
захирах	v. to direct, govern
алаг	adj. checkered
тах	n. horseshoe, shoe
хөнгөн	adj. easily, spry, nimble
захих	v. instruct
дахь	prep. upon (also modifier хоёр=two, хоёр дахь=second)
дээгүүр	prep. above
өөд	prep. for, toward, up
нандигнах	v. sanctify
харамгүй	n. generosity
дурлах	v. crave, desire, like
мөргөх	v. bump, bang, strike
нээх	v. detect, discover, open, start
хөөрөх	v. brag, swagger, converse
ховлох	v. denounce
цаашилбал	conj. furthermore
жааз	n. cadre, framework
шивэх	v. perforate, tattoo
зоог	n. feast
энгэр	n. board, flap, downhill
шархдах	v. injure, wound
төмөр	n. iron
элээх	v. to wear out
таяг	n. cane, stick
хугалах	v. fracture
гашуун	adj. biting, sour, salt
нулимс	n. brine, tears
урсгах	v. shed
цус	n. blood
аашилж	adj. lashing out
хорих	v. withdraw, suppress
дайрах	v. abuse, insult
үйл	n. action, needlework
лай	n. mud, dirt, trouble
гэхдээ	conj. however, but
хийлгэх	v. to force, call on
харгуй	n. path
жигүүртэн	n. bird
хөгжилдөх	v. liven, revel
жиргэх	v. chatter, chirp
зүрх	v. daring, nerve
баясгах	v. amuse
горхи	n. brook, creek
сэрүүцэх	v. to refresh
цугларах	v. accumulate, flock
халдах	v. catch, invade
довтлох	v. attack
тахиа	n. chicken
ар	n. background
ангайх	v. yawn
үмх	v. nibble
харуулах	v. show, exhibit
шулмас	n. demon
үнэр	n. scent, odor
үнэртэх	v. smell, savour
тулах	v. recline, touch, lean
тахир	adj. curly, winding
илбэ	n. magic, sorcery
хатан	n. madame, lady
ханд	n. extraction, liquor
өнхрөх	v. trundle
гутлаа	n. shoes
шивээ	n. barricade, fence
бүсгүй	n. young girl
орос	n. Russia
тусах	v. reflect
тэлүүр	n. frame for embroidery
хамба	n. bishop
зар	n. notice, spend
гэрэлтэх	v. illuminate, glorify
ханцуй	n. branch, sleeve
адуу	n. horse
гавлах	v. arrest, handcuff
эр	n. male
эндэх	n. to err, make a mistake
цуврах	v. drip, trickle
тогтоох	v. determine, establish, identify
ууль	n. owl
сандаргах	v. agitate, confuse
үүдэн	adj. front (teeth)
сүндэрлэх	v. lift, tower over
болор	n. pebble
цамхаг	n. tower
хээлэх	v. design, decorate
сийлэх	v. carve, engrave
довжоо	n. porch
хуар	n. decoration
баадан	n. kit
мэх	n. trap, trick
алдар	n. luster, glory
хэдий	adj. any, how many
шивнэх	v. murmur
дүр	n. expression, likeness
тагнах	v. scout out, pump
ангир	n. mandarin duck
амрах	v. rest
нойрон	n. sleep
дарагдах	v. pin under
ханах	v. satiate
угалз	n. sandstorm
маргааш	n. tomorrow
элэг	n. liver, sneer
зүрх	n. heart
тэврэх	v. embrace
нүцгэн	adj. bare, bleak
дусах	v. drop
халуу	n. heat
цоргих	v. jet
нутаг	n. shore, land
урвах	v. betray
уухай	n. cry
зарлигдах	v. order
тайх	v. hallow
ноёд	n. noblepeople
тариачид	n. peasantry
худалдаачид	n. tradefolk
цуглах	v. gather, congregate
гэм	n. defect, fault
шүүх	v. judge, prosecute
уулзах	v. encounter
тангараг	n. vow
хайрлах	v. cherish, favor, bestow
бараа	n. outline, silhouette
жинхэнэ	adj. authentic, factual
хагацаах	v. deprive
буудах	v. shoot
олны	adj. public
донсолго	n. jolt
зорих	v. pursue, purpose
худаг	n. water hole, well
төөнөх	v. glow, sear, grill
үхрийн	adj. related to cows
туурай	n. hoof
орох	v. enter
дэргэдүүр	adj. near
зориулах	v. devote to
эзгүй	adj. absent
эелдэг	adj. courteous
хунар	n. clothes
таних	v. identify, recognize
байтугай	conj. moreover (тэр ч байтугай)
унжих	v. hang
дасах	v. adapt
ширмэн	adj. cast-iron
балга	n. sip of ___
зайлах	v. evade
гомдох	v. grieve
ширүүн	adj. heavy, furious
бяцлах	v. smash
ёроол	n. bed, floor
чангаах	v. to pull
ногоо	n. grass
ороох	v. entwine, twist
уян	n. resilience
овсгоо	n. enterprise, push, drive
энцэлэх	v. end something
дараалах	v. to be next
булш	n. grave
залхуурах	v. to be lazy
хагарах	v. to break, split
сонин	n. newspaper
өлсгөлөн	n. hunger
хуцах	v. to bark, wolf
баахан	n. big number
мөөг	n. mushroom
шаахай	n. sandals
сүлжих	v. knit
халгаах	v. to be shy
цэлгэр	adj. large, spacious
цэнхэртэх	v. become blue
үүлэн	adj. cloudlike
ээрэх	v. hesitate, stutter
жирэлзэх	v. dash, run
баруун	n. right (as opposed to "left")
дахих	v. to repeat
орд	n. field, mansion
цагираг	n. ring, wheel
босгох	v. build
үсрэлт	n. lunge, jump
услах	v. irrigate
самнах	v. comb
зүс	n. color, appearance
цуг	adj. together
азаа	n. dare (as in азаа үзэх)
доог	n. mockery
духдуулах	v. put hat on head
морио	n. horse
хавирах	v. grind
уухайлах	v. cry out
тоос	n. dust, dirt
эрээн	adj. spotted, speckled
чичиргэх	v. to pulse
дөл	n. fire, light
дүрэлзэх	v. to inflame, blaze
утаа	n. smoke
олгойдох	v. spout
хадагдах	v. to nail
зогтусах	v. stop suddenly
илэх	v. caress, rub
хазаарлах	v. to restrain, bridle
толгод	n. rise, swell
ханарах	v. fall on the same side
ургаа	adj. rooted, growing
хоорондуур	prep. between
үй	adj. a lot (like үй олон)
үймэлдэх	v. to be in disorder
улс	n. country
ээлжлэх	v. rotate, alternate
хүршгүй	adj. untouchable,unconquerable
үсэргэх	v. to jet, spring, splash
дутах	v. to lack
цойлох	v. plunge
ахиад	adv. repeatedly
тасхийх	v. clank, growl
духах	v. to wear
амжих	v. to make, have time to do
шуугилдах	v. to make a lot of noise
эрэлхэг	adj. brave
сураг	n. news, rumor
боох	v. wrap
онцгой	adj. special, unique
туяа	n. radiance
цацрах	v. beam, radiate
шатаах	v. shoot, roast, singe
түшмэл	n. officer, clerc
найрах	v. to agree, mix
баршгүй	adj. infinite, limitless
уулгалах	v. plunder, surprise attack
хосгүй	adj. matchless, unparalleled
зочин	n. guest, visitor
аяг	n. habit, fit
шимшрэх	v. disappointed
гэзэг	n. braid, pigtail
арзайх	v. bristle
үнс	n. ash, cinder
тортог	n. smoke
цохих	v. jab, bash, hit
өчих	v. point out
тайлбар	n. comment, explanation
ойртох	v. approach
гялбах	v. flash, spark
инээдэм	n. humor
хөлгүй	adj. deep, steep
төгсөх	v. to finish
зодох	v. to hit, strike
томоотой	adj. well behaved
илүүдэх	v. exceed
нудрах	v. hit
дутуудах	v. to be inadequate
дугтчих	v. to twitch
магтах	v. to praise
цорвойх	v. to protrude
түлээ	n. wood for fire
хараах	v. curse
дэгдэх	v. fly up, escape
намдах	v. to ease, soothe
давардах	v. to overcome
хорвоо	n. earth
тонилгох	v. cause death, kill
минь	pron. my
үглэх	v. to grumble, complain
зөрөх	v. to disagree
хөллөх	v. hitch, harness
чарга	n. sleigh
гацуур	n. fir tree
даарах	v. feel cold
бөндгөнөх	v. move by rolling
чахрах	v. to squeak, creak
дулаахан	adj. warm
доошлох	v. descend,fall
няс	adj. crackling (as in тас няс)
бээрэх	v. freeze
эвлүүлэх	v. gather, assemble
хөдөлгөх	v. move
дээл	n. coat, garment
өдөх	v. challenge, provoke
нөмөргөх	v. sheet
зөнөг	adj. senile
оршуулах	v. bury
халууцах	v. swelter
гоёл	n. embroidery, garb
хөөр	n. zest, jubilation
сэлт	adj. imminent
ачих	v. load, stow, freight
хайрах	v. fry, sear
худлаа	n. lie, not true
цацарсан	adj. radiant
буулгах	v. demolish, lower, down
хөлдөх	v. freeze
шуурах	v. storm, tempest
хурдал	adv. hurry up
угтах	v. greet, welcome
мэргэ	n. prophecy
гөрөх	v. braid, entwine
шугуй	n. forest
хэсэх	v. scour, wander
үдшийн	n. nightfall
урам	n. enthusiasm
харвах	v. shoot, dart
нугалах	v. bend, fold
үүргэвч	n. knapsack
аз	n. luck
анх	adj. first
хором	n. instant, moment
үүрэглэх	v. drowse, nap
харуулдах	v. chip, shave
далавч	n. leaf, blade
шургах	v. creep in
ёсоор	adv. accordingly
дагина	n. pixy
асрах	v. nurse, tend to
халамжилсан	adj. tutorial
авлах	v. hunt
эзэн	n. boss
өчүүхэн	adj. inconspicuous, insignificant
төдий	adj. mere
бүхэл	adj. full, whole
багтаах	v. contain, comprise, include
хадан	adj. rocky
сүлжилдэх	v. interlace
сүрэглэх	v. flock, horde
гийх	v. shine
навч	n. blade, leaf
тохох	v. to put on
дэмий	adv. in vain
сайх	adj. the same
хүмүүс	n. people
гүйлдэх	v. run together
шаваарах	v. crowd
тохирох	v. convenient
сүйх	n. carriage
тэрэг	n. wagon
хүчлэх	v. to force
бус	???. not
мянга	adj. thousand
гүрэн	n. country
атгах	v. grasp, squeeze
байц	n. cliff
хөлөг	n. small boat
ийнхүү	adv. like this
гөлрөх	v. stare
хорчийх	v. wrap, mummify
турах	v. reduce, thin
ажих	v. look at
тогших	v. knock
хэрэх	v. loiter, roam
зохих	v. behoove, warrant, suit
хагацах	v. divoce, depart
учрах	v. happen, occur
тэгэхээр	conj. thereupon
сүвэгч	n. eyehole
бүтэх	v. realize, form
урамшуулах	v. embolden, encourage
шагнах	v. award, bestow, encourage
зарлиг	n. decree, ordinance
шаналах	v. regret, suffer
уй	n. sadness (as in уй гашуу)
ноорхой	adj. tattered, raggedy
уйтгарлах	v. to sadden
гэр	n. home
бүтээх	v. accomplish, invent, envelop
эргүү	n. idiot
заль	n. deceit, lie, ruse
даах	v. suffer
эцэслэх	v. to do away with, end, terminate
гүйцэлдэх	v. to complete
диваажин	n. heaven
сэлэм	v. sword, blade
бөндгөс	adv. to move by rolling
гудайлгах	v. bend head
гуниг	n. sadness
хатах	v. to dry
өмнөө	adj. distinctive
шид	n. mysterious power
бөмбөрөх	v. tumble, roll
гатлах	v. cross over
цуцах	v. to give up
шигүү	adj. thick, dense
жалга	n. valley
хоёул	adj. both
чөтгөр	n. demon,ghost
овоолох	v. to pile up
хааш	adj. whither
бороохойдох	v. club, bludgeon
мэндлэх	v. greet
зовних	v. sorrow
аягалах	v. pour
нойрсуулах	v. hypnotize
таашаагдах	???. please
үнэнч	adj. faithful
нойрсох	v. sleep
ял	n. accusation, condemnation
зэс	n. copper
тугалган	n. tin
бэрхшээх	v. despair
тоочих	v. to enumerate
нарлах	v. sunbathe
өвөрлөх	v. to harbor, nourish
тэртээх	v. located on the other side
гишгэх	v. to step
бахиар	n. pincer
хавчих	v. clamp
саваа	n. stick, rod
амт	n. aroma
хугарах	v. deflect
тахилзах	v. crooked
нахилзах	v. shake
янз	n. type of
лам	n. monk
жанчих	v. to beat, hit
ид	n. witchcraft (as in ид шид)
савалзах	v. move fast
давших	v. advance, progress
хэнхдэг	n. front of chest
сандрах	v. to be in confusion
түргэн	adv. quickly
түгжээ	n. lock
ухаан	n. intellect
эз	n. omen
занах	v. hatred, grudge
туйл	n. the extreme end of something, pole (like magnetic pole)
устгах	v. eliminate
эс	n. fiber, tissue, also "not to know" as in (эс мэдэх)
хууч	n. sickness
залгилах	v. lap, swill
сахих	v. maintain, preserve
арчих	v. mop, scrub
зорчих	v. ride, fare
үл	???. no, not
хүртэх	v. deserve, merit
удах	v. overstay
бодлогошрох	v. brood over
огторгуй	n. sky, space
элэх	v. soar, wear, hover
сургах	v. educate, instruct
хурах	v. congregate
хүдэр	n. ore
тэнгис	n. sea
даллах	v. beckon, wave
сэв	n. blemish
тов	n. date (as in time)
бөөрөнхий	adj. round
гүйцэтгэх	v. to carry out
наманчлах	v. confess, redeem
хазагдах	v. to be bitten
буурах	v. decrease
өрөх	v. set, arrange
нэрэлхэх	v. hesitate
зовох	v. worry, agonize
шалгаах	v. beseech, implore
саван	n. soap
хувцаслах	v. to clothe
бүлээн	adj. warm
хаяа	n. perspective, plane
араатан	n. beast, predator
бяц	n. small pieces
бухал	n. hay
ойчих	n. fall
хийлэх	v. pump, ventilate
жим	n. path, runway
таглах	v. cork, cover
хучигдсан	adj. under, cloudy
сахал	n. facial hair
хадам	adj. in-law
чанга	adj. abrupt, acute
торх	n. barrel, keg
жигнэх	v. steam, stew
гулууз	n. rolling pin
огтлох	v. cleave, chop
сармис	n. garlic
дүрэх	v. jab, thrust
сайшаах	v. applaud, praise
хог	n. dirt, garbage
үлдэгдэл	n. leftovers, odds and ends
чангалах	v. fix, fasten
амттан	n. candy, sweets
хэчнээн	adj. how many, what
түлэнхий	adj. sear, scorch
барах	v. deplete, drain
ач	n. favor
хүр	n. silkworm moth
солбих	v. cross, intersect
түрүүн	adv. previously
хүчит	adj. strong
хуйлрах	v. twirl, roll
жижигрэх	v. decrease
долгион	n. wave
гайхамшиг	n. phoenix, marvel
дундах	v. in the middle
хөвөх	v. swim, sail
зангуу	n. anchor
зав	n. free time
арлын	n. insular
гялалзах	v. to glow
шимтэх	v. to endeavor
арз	n. milk vodka
ирмэх	v. to twinkle, wink
дур	n. disposition, leaning
хашраах	v. annoy, irk
хормой	n. skirt
зуур	adv. while
цэр	n. spit
дээш	prep. above
цоор	n. pipe
зэр	n. weapons (like зэр зэвсэг)
туг	n. banner, flag
намирах	v. stream, wave, swing
жанжин	n. captain, general
үзүүр	n. end, extremity
цэнэ	n. cost
цутгалан	n. torrent, influx
найрлах	v. celibrate
эн	n. texture, width
согтох	v. get drunk
хуй	n. eddy, vortex
дарвуул	n. canvas
далбаа	n. banner
найртай	adj. friendly, sociable
мэдээ	n. information, data
илтгэх	v. report, profess
үхлийн	adj. deadly, fatal
аман	adj. verbal, oral
зэвсэг	n. instrument, weapon
тулалдах	v. battle, combat
жигдрэх	v. to be the same
нижигнэх	v. boom, bellow
хороо	n. bureau, commission
баривчлах	v. arrest, apprehend
бөмбөгдөх	v. bomb, shell
цахилах	v. flash, sparkle
амь	n. life, spirit
маргах	v. argue, contest
дэвэх	v. clap, flutter
өнжих	v. spend the day
далавчин	n. wing
таамаглах	v. to assume
хулгайлах	v. to steal
тордох	v. take care of
тоох	v. hold in high esteem
урсах	v. stream, seep
сох	n. wholly
зориглох	v. to have courage
хаг	n. knarl, scar
хөвөлзөх	v. move up and down
норгох	v. to make wet
сэрвээ	n. fin
май	n. cloud of smoke
гулгах	v. sliding
нугдах	v. to disappear
жиг	n. something strenge
далдлах	v. hide
шунгах	v. dive
гүр	n. metal stone
сэр	adj. puffy (like сэр сэр)
сэвэх	v. wave, fan
булаах	v. capture, seize
халхлах	v. shield, cover
танхи	adj. ladylike
гоёх	v. adorn, garnish
гоодох	v. dress up
шармал	adj. gilded
сондор	n. necklace
жавхаатай	adj. colorful
ганхах	v. jiggle, stagger, wobble
хойрго	adj. lazy, indolent
бүрий	n. nightfall, dusk
турш	adv. during, while, throughout
сөрөх	v. confront, dispute
гадуурхах	v. despise
шим	adj. juicy
ариун	adj. pure, sacred
нандин	adj. rare, sacred
хилэн	n. irritation
шоолох	v. joke, jest
бужиг	n. dance
чуулах	v. assemble
хор	n. evil, malice
сэтгэх	v. think
цэнгэх	v. to enjoy
шүүс	n. juice, sauce
гурвуу	adj. all three
булаг	n. fountain, spring
атаа	n. jealousy
арвалзах	v. infest
буцлах	v. to boil
гишүү	n. bough (like from a tree)
буурай	adj. weak
сагс	n. basket
бариулах	v. forfeit
малчин	n. cowboy
овгор	n. lump
номин	adj. azure blue
дэлгэрэх	v. blossom, flourish
зэгс	n. cane, reed
бишгүүр	n. trumpet
зэгсэн	adv. quite,respectably
хороох	v. to execute, kill, decrease
ухах	v. dig
худ	adj. in-law
хорсгох	v. sting the eyes
сөгдөх	v. kneel
цоож	n. lock
шүрших	v. scatter, sprinkle
жагсах	v. parade, demonstrate
зэрэгцэх	v. align, sync
давалгаалах	v. wave, undulate
долгилох	v. wave
цэлийх	v. continue, spread out
дорхноо	adv. immediately
халцрах	v. shed skin
ганганах	v. cackle
хэлтрэх	v. waive
цурхай	n. luce fish
цалгилах	v. to splat
хариг	adj. covetous, self-conscious
тушаал	n. appointment, office
тосгоны	adj. rural
инээмсэглэх	v. smile
бэргэн	n. daughter in law, sister in law
хүсэл	n. wishes, will
хангинуур	n. shrill sound
манаргах	v. stir trouble, stir dust
тээглэх	v. to halt
шавдах	v. to urge
хураах	v. to put away, seize, collect
уягдах	v. to be bound, tied
унагах	v. to throw
ачигдах	v. to load
өргөх	v. to lift
шивгэнэх	v. whisper
тэсэх	v. digest, endure, suffer
явдал	n. action, move
алгадах	v. smack, swat
чихэр	n. sugar, sweet
амлах	v. promise, vow
бараалхах	v. donate, give, present
туурга	n. side, wall
зарга	n. bill, lawsuit
байрлах	v. inhabit, intervene
уйлаан	n. cry
нус	n. drivel
хамах	v. scrape, sweep
давирхайдах	v. resin, tar
давуу	adj. tight, narrow
улайрах	v. become resolute, blush
шаргал	adj. yellowy
бүслүүр	n. hoop, zone
даруй	adv. immediately
уучлах	v. absolve, pardon
гагцхүү	adv. exclusively
өвгөрөх	v. to age
хөгшрөх	v. to mold, olden, age
зулай	n. crown
адис	n. blessing
ерөөл	n. blessing, benediction, toast
нум	n. bow, arc
сум	n. bullet, arrow
гарц	n. passage, exit
ноён	n. sir
шунгинах	v. whizz
ганихрах	v. grieve
бэр	n. sister in law, daughter in law, bride
цамц	n. shirt
шалах	v. urge, persuade
норох	v. get wet
гудайх	v. slant, tilt
тэтгэгч	n. supporter
дэвхрэх	v. skip, hop
боолт	n. cord,bandage
алаглах	v. to look colorful
ёстой	adj. ought, proper, should
наадам	n. festival,show
жонхуу	n. adhesive
хэмхлэх	v. pulverize, smash
нууц	adj. clandestine, classified
дуурайх	v. imitate, mimic
барлаг	n. attendant, retainer
ёслол	n. ceremony, ritual
гуних	v. sadden, gloom
дооглох	v. mock, jeer
нэгжих	v. search, rummage
хөвгүүд	n. boys
шилтгээн	n. castle
сугар	n. venus
болшгүй	adj. impossible
гялбалзах	v. twinkle
тунгалаг	adj. lucent, bright, crystal
түших	v. recline, depend, link
үлдсэн	adj. extra, residual
дун	n. shell, snail
шагших	v. surprised
цацагдах	v. sprinkle, spray
сэм	adv. stealthily
хэдрэг	n. instrument for hide tanning
нут	adj. strong, solid
цох	n. beetle
ураг	n. relationship
хэт	adj. exceedingly, over
байг	n. target
задрах	v. to eliminate, unwind
цоорхой	n. gap, opening
шагайх	v. to aim
онилох	v. to aim
магад	adj. certain, definite
багтрах	v. seizure, thrash
халгих	v. burp, overflow
махир	adj. curly, bent
туйпуу	n. brick
цайлах	v. to treat to tea
тэмцэх	v. wrestle, contend
гэдсэн	adj. stay down (as in гэдсэн дотор)
авдар	n. suitcase, trunk
огло	v. break off (like огло үсрэх)
өн	adj. richness, abundance
дуслах	v. drip, ooze
тийчлэх	v. kick
өргөө	n. residence
өтөл	adj. old
язгуур	n. lineage, root
нутаглах	v. inhabit, live
хэв	n. shape, mold
бүлгээ	v. was
хорь	adj. twenty
гуа	adj. gorgeous
түм	n. multitude, ten thousand
агнах	v. hunt
хориглох	v. forbid, inhibit
харилцах	v. communicate, mix
бурхан	n. deity
нүүх	v. move, vacate
сохор	adj. blind, ignorant
дэрвэх	v. swing, wave
авга	n. parental relative (like uncle)
доромжлох	v. insult, outrage
овог	n. last name
гунж	n. young animal (like a young cow)
хавирга	n. flank, side
цорой	n. cramp
шорлох	v. to skewer
уушги	n. lung
зул	n. light
буг	n. demon, devil
дал	n. seventy, shoulder blade
баглаа	n. cluster, pack
сэжиглэх	v. mistrust, suspect
шарвах	v. slide, wag
адилтгах	v. compare, identify
эв	n. harmony, dexterity
нэгтгэх	v. generalize, integrate
баглах	v. pack, bind
бэх	n. ink
хялбар	adj. easy, accessible
дийлэгдэх	v. lose ground
мунхаг	adj. dark, dense, stupid
бядуу	adj. stupid
тооцох	v. consider, score
тоологдох	v. enumerate
атал	adv. yet
мэрэх	v. knaw
харцага	n. hawk
мяраах	v. prowl, glide
сэг	n. carrion
мөч	n. limb, space, minute
олгох	v. allow, grant
ялзрах	v. corrupt
эсэг	n. leaven
салхилах	v. blow, storm
бутрах	v. crumble
хүлэх	v. bind
айсуй	adj. imminent
хатир	n. trot
өгүүлрүүн	v. said
хайхармаагүй	conj. regardless
өгүүлэх	v. say
шийр	n. shank
чацуу	adj. same
иргэн	n. citizen
хянагч	n. inspector
жирэмсэн	adj. big
харь	adj. strange
нэрийдэл	n. guise, name
бодон	n. boar
баатар	n. hero
инж	n. dot
тайлга	n. rite
татвар	n. tax
ямагт	adv. always
авир	n. character, model
хоч	n. alias
эрдэм	n. knowledge, learning
адармаа	n. deception
татаар	n. Tatar
баригдах	v. captivity, wallow
тайж	n. nobleman
тамтарсан	adj. ramshackle
барагдах	v. exhaust, dwindle
өшөө	n. feud, enmity
хөт	n. guide
ташуурдах	v. flog, whip
бэл	adj. downhill
дутаах	v. flee
хошуу	v. beak, muzzle, nose
үлдэх	v. continue
бэрх	v. difficult, hard
тутам	adj. each
амиа	n. sacrifice
хээр	n. chesnut
хөдөө	n. countryside
гэтлэх	v. conquer, negotiate
давуулах	v. outdo
ятгах	v. admonish, convict, get, exhort
жаргал	n. pleasure
бүжиг	n. dance
өргөмжлөх	v. exalt, glorify
сал	n. float, raft
саглагар	n. rank, exuberant
олом	n. ford, cinch
нэвтрэх	v. enter, permeate
бархирах	v. exclaim, screech
тэнхрэх	v. recuperate, refresh
гуужих	v. peel, slough
шадар	adv. nearby
зэмлэх	v. blame, accuse
буруушаах	v. blame, accuse, criticize
балмад	adj. brute, foolish, rude
барс	n. ounce
цөөвөр	adj. lesser
хэрцгий	adj. barbarous, bitter, cruel
нүгэл	adj. evil
гэдрэг	adj. backward, flatways
нядлах	v. kill, slaughter
нялх	n. baby
мангас	n. monster
залгих	v. devour,gulp
хэвэл	n. belly
шарга	adj. orange-brown
довцог	n. small hill
ойшоохгүй	adj. insolent
цайвар	adj. blond, fair
жараахай	n. minnow
эрэмдэг	adj. disabled, monstrous
төгөлдөр	adj. complete, entire
сайд	n. minister
засаг	n. government
хутагт	n. saint, pontiff
гогод	n. leek
өсгөх	v. culture, enhance, foster
дэгээ	n. hanger, holdfast, peg
гох	v. hook, hitch, click
малтах	v. dig, mine
цавчим	n. ascent
шор	n. skewer, spit
уруудах	v. dip, slope
оёдол	n. needlework
оюун	n. intellect
тарах	v. disband, permeate, scatter
жадлах	v. spear, thrust
зоох	v. plunge, jab
тохиол	n. accident, episode
байлдах	v. combat, battle
байгуулах	v. conclude, create, found
хайхрах	v. heed
ширгэх	v. evaporate, shallow, shoal
хождох	v. lag
архи	n. alcohol
хишиг	n. blessing
ихсэх	v. grow
хоцрогдол	n. hangover
уярах	v. melt
сэргээх	v. animate, enliven
мөрөөдөх	v. dream, yearn
хоцорсон	adj. tardy
дотор	prep. among, inside
холих	v. blend, combine
доромжлогдсон	adj. abject
эрхэмлэгддэг	adj. preferential
эзэмших	v. engage, manage, occupy
зэлэгч	n. occupant
дэвших	v. progress, advance
хатирах	v. trot
дохиолох	v. motion
аймгийн	adj. tribal
хиа	n. page, aide-de-camp
гайхал	n. amazement
зүүд	n. dream
нагац	n. uncle
өлгий	n. cradle, diaper
голомт	n. fireplace
нөж	n. clot, gout
сайтар	adv. thoroughly
тогтмол	adj. constant
цохио	n. cliff, rock
сахиул	n. guardian, warden
дорой	adj. frail, low, poor
шийтгэх	v. blame, condemn
саад	n. barrier, delay
завсар	n. clearance, slit
баясах	v. enjoy, amuse
тайлагдах	v. uncoil, unwind
залуу	n. guy, lad
тэлээ	n. belt
мунгинах	v. flounder, linger
ойртох	v. approach
хоцрох	v. lag, backwards
дохих	v. beckon, gesticulate
уурга	n. lasso
мөшгөх	v. pursue
сураглах	v. ask
гавшгай	n. alert, brisk
налархай	adj. lithe, supple
оготор	n. bob, bun, dock
шингэсэн	adj. saturated
үдэш	n. evening
дээрэмдэх	v. holdup, flay, pillage
дээрэм	n. pillage, piracy
агт	n. steed
шивээлэх	v. pale
хур	n. grouse
эрмэг	adj. masculine, sterility
татлах	v. jot
амсар	n. lip, mouth
исэр	n. stool
нэгж	n. unit
унгас	n. fleece, hair, wool
баримтлах	v. exercise, observance, upheld
самар	n. nut
гинж	n. bond, chain
аврах	v. redeem
дөнгө	n. shackles, fetter
бэдрэх	v. pursue
саад	n. barrier